1111111111111111
1CC00C0100000101
1E11100100111101
10000PC1000000C1
1000000000000001
1111111111111111
1000000000000001
1111111111111111